####################
#..................#
#..................#
#..................#
#..................#
#.........p........#
#........._........#
#......s.0T0.s...._#
#__________________#
#._................#
#._................#
####################